chaos
grifting-goat
####################################################################################################
##            ##                    ##                ##                              ##          ##
##                                      ##          ##                                ####        ##
##                          ##                                ##                                ####
##                            ####                                ##      ##      ##              ##
##    ##                                              ##            ##            ##            ####
##                    ##      ##  ##                              ##      ##                      ##
##    ##  ##              ##                ##                  ##                                ##
####        ##                        ##                  ##          ##                          ##
##                  ##      ##                                                                    ##
##                      ##    ##          ##        ##              ##              ##        ##  ##
##              ##  ##                          ##                          ##    ##      ##      ##
####        ##        ####      ##          ##                                        ##  ##      ##
##                                                                                  ##            ##
##        ####              ##                                                          ##        ##
##          ##      ##    ##  ##      ##          ##                                              ##
##    ##                      ##                                ##                ##              ##
##                    ##          ##        ##          ##                                        ##
##                                                                    ##  ##                    ####
##      ##                            ##    ##                                      ##            ##
##                                                                    ##                          ##
##                ##              ##    ##          ##                                            ##
##                                  ####        ##                              ####              ##
##    ##                    ##        ##    ##                                                    ##
##                                              @                                                 ##
##                ####                            ##                                              ##
##          ##                                ##                            ##                    ##
##    ####        ##    ##              ##                              ##                        ##
##                              ##    ##    ##  ##                    ##    ##                    ##
##                ##  ##    ##                                                          ##      ####
##                                  ##                                  ##  ##            ##    ####
##    ####  ##                ####                        ##                                      ##
##                            ##                                                                  ##
####                  ##            ##                  ##                                ##      ##
##                    ##  ##  ##                ##                                                ##
##                                          ##                                                    ##
##                ##                        ##        ##          ##              ##              ##
##          ##  ##                              ##                            ##      ##      ##  ##
##                                                ##                        ##                    ##
##                                                                                  ####          ##
##                                            ##                                                  ##
##        ##                  ####    ##            ##                                    ##      ##
##                                      ##          ##                                            ##
####                  ##                      ##                                  ##              ##
##        ####              ##  ##      ##                                                        ##
##                                      ##          ##                                            ##
##                                                  ##                      ##      ##            ##
##            ######      ##  ##                                          ####          ##        ##
##                                    ##                  ##                                      ##
####################################################################################################
